................
................
................
................
................
................
......~~~~......
......~xx~......
......~xx~......
......~~~~......
................
................
................
................
................
................