................
................
................
................
................
................
......~~~~......
......~##~......
......~##~......
......~~~~......
................
................
................
................
................
................