................
................
................
................
.......~~~~.....
....~~~~00~.....
....~06188~.....
....~06..3~~....
....~~7..20~....
.....~44520~....
.....~00~~~~....
.....~~~~.......
................
................
................
................