................
................
................
........~.......
.....~~~0~~.....
....~~.188~~....
....~6.....~....
...~06....3~....
....~7....20~...
....~.....2~....
....~~445.~~....
.....~~0~~~.....
.......~........
................
................
................