~~~~~~~~~~~~~~~~
~~~~~~~~~~~~~~~~
~~~~~~~~~~~~~~~~
~~~~~~~~~~~~~~~~
~~~~~06..~~~~~~~
~~~~~......0~~~~
~~~~~......8~~~~
~~~~........~~~~
~~~~........~~~~
~~~~4......~~~~~
~~~~0......~~~~~
~~~~~~~..20~~~~~
~~~~~~~~~~~~~~~~
~~~~~~~~~~~~~~~~
~~~~~~~~~~~~~~~~
~~~~~~~~~~~~~~~~