................
................
................
................
................
................
................
................
................
................
................
.**.............
3**5............
2006............
2006............
1887............