.3**...........
.206.....**....
.187...****44**
......30***00**
......18******.
.........***...