..**...........
...............
...@...0**.....
.......8**5....
........*06....
.........87....