34##...........
2006.....##....
2006...####44##
1887..30###00##
......18######.
.........###...