.................
.................
......#####......
.....#...........
....#............
....#.......#....
....#.......#....
....#.......#....
....#.......#....
....##.....##....
....9#######7....
.......vvv.......
.................
.................
.................
.................
.................
.................
.................
.................
.................