.................
......#####......
....###~~~###....
....#~~~~~~~#....
...##~~~~~~~##...
...#~~~~~~~~~#...
...#~~~~~~~~~#...
...#~~~~~~~~~#...
...##~~~~~~~##...
....#~~~~~~~#....
....###~~~###....
......#####......
..#....#T#....#..
...#..##v##..#...
....###...###....
....9##^#^##7....
.....9#v#v#7.....
......#.#.#......
......v.v.v......
.................
.................