.................
.x....#####....x.
....###~~~###....
....#~~~~~~~#....
...##~~~~~~~##...
...#~~~~~~~~~#...
...#~~~~~~~~~#...
...#~~~~~~~~~#...
...##~~~~~~~##...
...w#~~~~~~~#....
...w#########....
...wW~#####......
..#wW~~###....#..
...#W~##~##..#...
....###~#~###....
....#########....
.....##T#T##.....
......#v#v#......
......#.#.#......
.................
x...............x