.................
.......###.......
.....##..w##.....
....#....wW~#....
....#......w#....
...#.........#...
...#.........#...
...#.........#...
....#.......#....
....#.......#....
.....##...##.....
..#...#####...#..
..v..........3v..
...91.##.##..7...
....vvv7.9vvv....
.................
.................
.................
.................
.................
.................