.................
.......###.......
.....##~~~##.....
....#.wW~~~~#....
....#..wW~~~#....
...#.....wW~~#...
...#........w#...
...#.........#...
....#.......#....
....#..@....#....
.....##...##.....
..#...#####...#..
..#....>.<....#..
...#..##.##..#...
....###...###....
......9.v.7......
.................
.................
.................
.................
.................