.................
.................
.....3^^^^.......
....3###.........
....<#...........
....<#......>....
....<#......>....
....<#......>....
....<#......>....
....9#######7....
.....9vvvvv7.....
.................
.................
.................
.................
.................
.................
.................
.................
.................
.................