~~~~~~~~~~~~~~~~~
~~~~~~#####~~~~~~
~~~~###~~~###~~~~
~~~~#~~~~~~~#~~~~
~~~##~~~~~~~##~~~
~~~#~~~~~~~~~#~~~
~~~#~~~~~~~~~#~~~
~~~#~~~~~~~~~#~~~
~~~##~~~~~~~##~~~
~~~~#~~~~~~~#~~~~
~~~~###~~~###~~~~
~~~~~~#####~~~~~~
~~#~~~~###~~~~#~~
~~~#~~##~##~~#~~~
~~~~###~#~###~~~~
~~~~#########~~~~
~~~~~#######~~~~~
~~~~~~#####~~~~~~
~~~~~~#~#~#~~~~~~
~~~~~~~~~~~~~~~~~
~~~~~~~~~~~~~~~~~