.................
.......^^^.......
.....###.###.....
....##...........
....#.......#....
...3#.......#1...
...<.........>...
...9#.......#7...
....#.......#....
....##.....##....
..3###########1..
..97...###...97..
.......###.......
.......v#v.......
.................
.................
.................
.................
.................
.................
.................