.........................
.........................
.........................
...........###...........
.........................
..#...................#..
..#...#############...#..
..#...#############...#..
......#############......
......#############......
......#############......
......#############......
......#############......
......#####000#####......
..........18887..........
.........................
.........................
....###...........###....
.........................
............@............
.........................
.........................
.........................
.........................