.........######.........
......############......
..####################..
..########....########..
..######........######..
..####............####..
.####..............####.
.####..............####.
.###................###.
####................####
###..................###
###..................###
###..................###
###..................###
####................####
.###................###.
.####..............####.
.####..............####.
..####............####..
..######........######..
..########....########..
..####################..
......############......
.........######.........