.........######.........
......###......###......
..####....####....####..
..##....##....##....##..
..#...##........##...#..
..#..#............#..#..
.#..#..............#..#.
.#..#..............#..#.
.#.#................#.#.
#..#................#..#
#.#..................#.#
#.#..................#.#
#.#..................#.#
#.#..................#.#
#..#................#..#
.#.#................#.#.
.#..#..............#..#.
.#..#..............#..#.
..#..#............#..#..
..#...##........##...#..
..##....##....##....##..
..####....####....####..
......###......###......
.........######.........