................
................
......34445.....
......#0006.....
.....######.....
.....######.....
................
................
................
----------------
----------------
................
................
................
................
................
..3444445.......
..2000006.......
..20###06.......
..2000006.......
..#888887.......
................
................