................
.....3444445....
.....2000006....
.....20###06....
..344#####06....
..200#######445.
..20##8888##006.
..2006.....1887.
..1887..........
----------------
----------------
...@............
.......3444445..
.......2000006..
.344444#0#0006..
.200000000#887..
.20######06.....
.20######06.....
.20######06.....
.20######06.....
.2000000006.....
.1888888887.....
................