............##..
............##..
................
.............##.
.............##.
.....444444.....
.....000000.....
.....######.....
.....######.....
................
................
................