............##..
............##..
.............#..
.....######..##.
.....######..##.
.....######.....
................
......#..#......
................
................
................
................