............##..
............##..
....##..........
....##.####..##.
.....#....#..##.
.....####.#.....
................
......#..#......
..............@.
----------------
----------------
................