................
................
................
****************
................
................
...*44....44*...
...*00....00*...
...***....***...
....**....**....
................
................
............**..
................
................
................