................
4444444444444444
0000000000000000
****************
................
................
................
................
.....344445.....
.....200006.....
................
................
............44..
................
.............@..
................