................
................
................
****************
...*06....20*...
...*06....20*...
...***....***...
...*.*....*.*...
...***....***...
....***..***....
................
................
...........3**5.
...........2006.
...........2006.
...........1887.