*44445......34444*
*0000*......*0000*
****06......20****
****06......20****
****06......20****
****06......20****
*0000*......*0000*
*88887......18888*