.........
.........
..($)....
..$$$....
..[$]....
.........
.........