#########
##].[####
#]...[###
#.....###
#)...(###
##).(####
#########